24 15
xxxxxxxxxxxxxxx
x-------------x
x-------------x
x----g--------x
x-------------x
x-------------x
x----xxx------x
x-------------x
x-------------x
x-------------x
x---xxx-------x
x-------------x
x-------------x
x-------------x
x-------------x
x-------------x
x------xx----xx
x-----xxxx---xx
x------xxxxx--x
x----------x--x
x-----------xxx
x-------------x
x-----------r-x
xxxxxxxxxxxxxxx